id,vf,course,trial,left,start,stop,obj_coll,gripper_coll,duration
0,0,Course1,0,1,39034980,39041202,0,0,6222
0,0,Course1,1,1,39046051,39049702,0,0,3651
0,0,Course1,2,1,39054149,39058325,0,0,4176
0,0,Course1,3,1,39062425,39065995,0,0,3570
0,0,Course1,4,1,39069565,39072902,0,0,3337
0,0,Course1,5,1,39076644,39081661,0,0,5017
0,0,Course2,0,1,39086804,39097139,0,0,10335
0,0,Course2,1,1,39101865,39110454,0,1,8589
0,0,Course2,2,1,39114286,39124360,0,0,10074
0,0,Course2,3,1,39128504,39136424,0,0,7920
0,0,Course2,4,1,39140192,39148118,0,1,7926
0,0,Course2,5,1,39152485,39160404,0,0,7919
0,0,Course3,0,1,39166358,39184151,2,4,17793
0,0,Course3,1,1,39189256,39216264,2,6,27008
0,0,Course3,2,1,39222513,39249293,2,2,26780
0,0,Course3,3,1,39254387,39279467,4,4,25080
0,0,Course3,4,1,39284767,39301834,1,0,17067
0,0,Course3,5,1,39307541,39325189,0,2,17648
0,1,Course1_VF,0,1,40000414,40007183,0,0,6769
0,1,Course1_VF,1,1,40011549,40017124,0,0,5575
0,1,Course1_VF,2,1,40020955,40025925,0,0,4970
0,1,Course1_VF,3,1,40029354,40033744,0,0,4390
0,1,Course1_VF,4,1,40037385,40042546,0,0,5161
0,1,Course1_VF,5,1,40046757,40051437,0,0,4680
0,1,Course2_VF,0,1,40057602,40073284,0,1,15682
0,1,Course2_VF,1,1,40076982,40089011,0,0,12029
0,1,Course2_VF,2,1,40092541,40103152,0,0,10611
0,1,Course2_VF,3,1,40107016,40117124,0,0,10108
0,1,Course2_VF,4,1,40121023,40130496,0,0,9473
0,1,Course2_VF,5,1,40133622,40141809,0,0,8187
0,1,Course3_VF,0,1,40146144,40166886,0,1,20742
0,1,Course3_VF,1,1,40170616,40187617,0,0,17001
0,1,Course3_VF,2,1,40191035,40205499,0,0,14464
0,1,Course3_VF,3,1,40208604,40219707,0,0,11103
0,1,Course3_VF,4,1,40223427,40236596,0,0,13169
0,1,Course3_VF,5,1,40239913,40251921,0,1,12008
1,1,Course1_VF,0,1,43683620,43686557,0,0,2937
1,1,Course1_VF,1,1,43690991,43693951,0,0,2960
1,1,Course1_VF,2,1,43699659,43702351,0,0,2692
1,1,Course1_VF,3,1,43705668,43707690,0,0,2022
1,1,Course1_VF,4,1,43710807,43712772,0,0,1965
1,1,Course1_VF,5,1,43715810,43717676,0,0,1866
1,1,Course2_VF,0,1,43724601,43730253,0,0,5652
1,1,Course2_VF,1,1,43733302,43739256,0,0,5954
1,1,Course2_VF,2,1,43742662,43749497,0,1,6835
1,1,Course2_VF,3,1,43752637,43760165,0,1,7528
1,1,Course2_VF,4,1,43763103,43770910,0,0,7807
1,1,Course2_VF,5,1,43775970,43783833,0,0,7863
1,1,Course3_VF,0,1,43793729,43808429,0,4,14700
1,1,Course3_VF,1,1,43812472,43830243,0,0,17771
1,1,Course3_VF,2,1,43833404,43854201,0,1,20797
1,1,Course3_VF,3,1,43857408,43877279,0,0,19871
1,1,Course3_VF,4,1,43880193,43899193,0,0,19000
1,1,Course3_VF,5,1,43902264,43916327,0,0,14063
1,1,Course1,0,1,44713758,44715349,0,0,1591
1,1,Course1,1,1,44718024,44720158,0,0,2134
1,1,Course1,2,1,44722894,44724960,0,0,2066
1,1,Course1,3,1,44727586,44729623,0,0,2037
1,1,Course1,4,1,44732188,44734031,0,0,1843
1,1,Course1,5,1,44736488,44738431,0,0,1943
1,1,Course2,0,1,44741861,44748070,0,2,6209
1,1,Course2,1,1,44753867,44761161,0,0,7294
1,1,Course2,2,1,44763898,44771493,0,0,7595
1,1,Course2,3,1,44774207,44782439,0,0,8232
1,1,Course2,4,1,44785121,44794145,0,0,9024
1,1,Course2,5,1,44797049,44805404,0,0,8355
1,1,Course3,0,1,44809436,44823543,0,0,14107
1,1,Course3,1,1,44826403,44839450,0,1,13047
1,1,Course3,2,1,44842097,44857108,0,0,15011
1,1,Course3,3,1,44859833,44876018,0,0,16185
1,1,Course3,4,1,44878699,44894191,0,0,15492
1,1,Course3,5,1,44896805,44909795,0,0,12990
2,0,Course1,0,0,54558570,54559579,0,0,1009
2,0,Course1,1,0,54563251,54564021,0,0,770
2,0,Course1,2,0,54568221,54568969,0,0,748
2,0,Course1,3,0,54573225,54573951,0,1,726
2,0,Course1,4,0,54577246,54578017,0,0,771
2,0,Course1,5,0,54580887,54581546,0,0,659
2,0,Course2,0,0,54584763,54587224,0,1,2461
2,0,Course2,1,0,54591420,54596637,0,1,5217
2,0,Course2,2,0,54599854,54603137,1,1,3283
2,0,Course2,3,0,54609067,54611603,0,1,2536
2,0,Course2,4,0,54613915,54617501,0,1,3586
2,0,Course2,5,0,54621031,54623142,1,1,2111
2,0,Course3,0,0,54629408,54632033,1,4,2625
2,0,Course3,1,0,54635116,54637472,1,3,2356
2,0,Course3,2,0,54639985,54642577,0,3,2592
2,0,Course3,3,0,54645347,54647804,0,2,2457
2,0,Course3,4,0,54650239,54653032,0,4,2793
2,0,Course3,5,0,54655378,54657812,0,1,2434
2,0,PauseVF,0,0,54970785,54971624,1,3,839
2,0,PauseVF,1,0,54975164,54975465,0,0,301
2,0,PauseVF,2,0,54978012,54978403,0,0,391
2,0,PauseVF,3,0,54979922,54980324,0,0,402
2,0,PauseVF,4,0,54981821,54982201,0,0,380
2,0,PauseVF,5,0,54983619,54983910,0,0,291
2,0,Course1_VF,0,0,54986746,54987450,0,1,704
2,0,Course1_VF,1,0,54989249,54990041,0,0,792
2,0,Course1_VF,2,0,54991729,54992533,0,0,804
2,0,Course1_VF,3,0,54994163,54994945,0,0,782
2,0,Course1_VF,4,0,54996587,54997425,0,0,838
2,0,Course1_VF,5,0,54999301,55000195,0,0,894
2,0,Course2_VF,0,0,55002395,55005321,0,1,2926
2,0,Course2_VF,1,0,55007277,55010449,0,2,3172
2,0,Course2_VF,2,0,55012816,55015385,0,1,2569
2,0,Course2_VF,3,0,55018324,55021484,0,2,3160
2,0,Course2_VF,4,0,55024211,55026354,0,2,2143
2,0,Course2_VF,5,0,55028499,55031202,0,1,2703
2,0,Course3_VF,0,0,55033301,55035782,0,6,2481
2,0,Course3_VF,1,0,55037903,55040294,1,7,2391
2,0,Course3_VF,2,0,55042762,55044907,1,5,2145
2,0,Course3_VF,3,0,55047130,55049475,0,6,2345
2,0,Course3_VF,4,0,55051497,55053396,0,7,1899
2,0,Course3_VF,5,0,55055462,55057506,0,3,2044
3,1,Course1_VF,0,1,56489024,56492832,0,2,3808
3,1,Course1_VF,1,1,56498160,56502707,0,0,4547
3,1,Course1_VF,2,1,56507364,56511107,0,0,3743
3,1,Course1_VF,3,1,56515350,56517919,0,0,2569
3,1,Course1_VF,4,1,56522376,56525224,0,0,2848
3,1,Course1_VF,5,1,56529458,56532328,0,0,2870
3,1,Course2_VF,0,1,56538181,56553830,0,2,15649
3,1,Course2_VF,1,1,56558375,56566809,0,1,8434
3,1,Course2_VF,2,1,56570093,56580514,0,1,10421
3,1,Course2_VF,3,1,56584334,56595102,0,0,10768
3,1,Course2_VF,4,1,56598385,56609823,0,0,11438
3,1,Course2_VF,5,1,56614939,56627694,0,0,12755
3,1,Course3_VF,0,1,56633357,56650234,1,1,16877
3,1,Course3_VF,1,1,56657807,56675031,0,4,17224
3,1,Course3_VF,2,1,56681766,56697314,0,3,15548
3,1,Course3_VF,3,1,56703536,56718034,0,3,14498
3,1,Course3_VF,4,1,56722423,56738686,0,1,16263
3,1,Course3_VF,5,1,56746349,56763506,0,0,17157
3,0,Course1,0,1,57384490,57388768,0,0,4278
3,0,Course1,1,1,57392454,57394688,0,0,2234
3,0,Course1,2,1,57398240,57400061,0,0,1821
3,0,Course1,3,1,57403579,57405109,0,0,1530
3,0,Course1,4,1,57408293,57409856,0,0,1563
3,0,Course1,5,1,57412660,57414168,0,0,1508
3,0,Course2,0,1,57417708,57425728,0,0,8020
3,0,Course2,1,1,57428878,57436249,0,1,7371
3,0,Course2,2,1,57440203,57446268,0,0,6065
3,0,Course2,3,1,57449217,57455896,0,0,6679
3,0,Course2,4,1,57459214,57464631,0,1,5417
3,0,Course2,5,1,57467546,57472885,0,2,5339
3,0,Course3,0,1,57477476,57487339,0,2,9863
3,0,Course3,1,1,57490367,57499771,0,1,9404
3,0,Course3,2,1,57503446,57512024,0,2,8578
3,0,Course3,3,1,57515152,57525673,0,2,10521
3,0,Course3,4,1,57530454,57543802,0,2,13348
3,0,Course3,5,1,57547108,57561014,0,1,13906
4,0,Course1,0,1,35725259,35726142,0,0,883
4,0,Course1,1,1,35733224,35733972,0,0,748
4,0,Course1,2,1,35735915,35736608,0,0,693
4,0,Course1,3,1,35739210,35739936,0,0,726
4,0,Course1,4,1,35742047,35742774,0,0,727
4,0,Course1,5,1,35744795,35745622,0,0,827
4,0,Course2,0,1,35747789,35750849,0,0,3060
4,0,Course2,1,1,35752960,35756434,0,1,3474
4,0,Course2,2,1,35758936,35763247,0,1,4311
4,0,Course2,3,1,35766755,35771759,0,0,5004
4,0,Course2,4,1,35774819,35778784,0,0,3965
4,0,Course2,5,1,35781253,35785777,0,0,4524
4,0,Course3,0,1,35789898,35798566,0,3,8668
4,0,Course3,1,1,35801816,35811091,0,2,9275
4,0,Course3,2,1,35820011,35825942,1,2,5931
4,0,Course3,3,1,35829729,35836241,0,1,6512
4,0,Course3,4,1,35840720,35846885,0,2,6165
4,0,Course3,5,1,35850672,35856189,0,1,5517
4,0,PauseVF,0,1,36357382,36378671,3,3,21289
4,0,PauseVF,1,1,36382669,36383071,0,0,402
4,0,PauseVF,2,1,36384803,36385417,0,0,614
4,0,PauseVF,3,1,36388702,36389159,1,1,457
4,0,PauseVF,4,1,36390936,36394052,2,1,3116
4,0,PauseVF,5,1,36397381,36397771,0,0,390
4,0,Course1_VF,0,1,36399648,36400631,0,0,983
4,0,Course1_VF,1,1,36403110,36404283,0,0,1173
4,0,Course1_VF,2,1,36406473,36407813,0,1,1340
4,0,Course1_VF,3,1,36409879,36411209,0,0,1330
4,0,Course1_VF,4,1,36413197,36414526,0,0,1329
4,0,Course1_VF,5,1,36416715,36417742,0,0,1027
4,0,Course2_VF,0,1,36422669,36427996,0,1,5327
4,0,Course2_VF,1,1,36431147,36435603,0,1,4456
4,0,Course2_VF,2,1,36438976,36444873,0,0,5897
4,0,Course2_VF,3,1,36447666,36452905,0,1,5239
4,0,Course2_VF,4,1,36455876,36460099,0,1,4223
4,0,Course2_VF,5,1,36462991,36467537,0,0,4546
4,0,Course3_VF,0,1,36471580,36480918,0,2,9338
4,0,Course3_VF,1,1,36484113,36492691,0,1,8578
4,0,Course3_VF,2,1,36495371,36502609,0,3,7238
4,0,Course3_VF,3,1,36506027,36512729,0,0,6702
4,0,Course3_VF,4,1,36515142,36518616,0,3,3474
4,0,Course3_VF,5,1,36520605,36523397,0,0,2792
5,1,Course1_VF,0,1,42599532,42602570,0,0,3038
5,1,Course1_VF,1,1,42607697,42610568,0,0,2871
5,1,Course1_VF,2,1,42614555,42617057,0,0,2502
5,1,Course1_VF,3,1,42620632,42622664,0,0,2032
5,1,Course1_VF,4,1,42625792,42627578,0,0,1786
5,1,Course1_VF,5,1,42631655,42634739,0,0,3084
5,1,Course2_VF,0,1,42640748,42646634,0,1,5886
5,1,Course2_VF,1,1,42650365,42655816,0,0,5451
5,1,Course2_VF,2,1,42658955,42664674,0,0,5719
5,1,Course2_VF,3,1,42667645,42672437,0,0,4792
5,1,Course2_VF,4,1,42675452,42680880,0,1,5428
5,1,Course2_VF,5,1,42683975,42689715,0,0,5740
5,1,Course3_VF,0,1,42700739,42713529,1,4,12790
5,1,Course3_VF,1,1,42716936,42726988,0,1,10052
5,1,Course3_VF,2,1,42750657,42760565,0,2,9908
5,1,Course3_VF,3,1,42768361,42779173,0,0,10812
5,1,Course3_VF,4,1,42782970,42792543,0,1,9573
5,1,Course3_VF,5,1,42796273,42804394,0,0,8121
5,1,Course1,0,1,43469465,43471777,0,0,2312
5,1,Course1,1,1,43475105,43477083,0,0,1978
5,1,Course1,2,1,43479933,43481561,0,0,1628
5,1,Course1,3,1,43484276,43485806,0,0,1530
5,1,Course1,4,1,43488599,43490520,0,0,1921
5,1,Course1,5,1,43493502,43495133,0,0,1631
5,1,Course2,0,1,43498696,43503856,0,0,5160
5,1,Course2,1,1,43506761,43511239,0,1,4478
5,1,Course2,2,1,43513976,43518477,0,0,4501
5,1,Course2,3,1,43521192,43525906,0,0,4714
5,1,Course2,4,1,43528887,43532708,0,0,3821
5,1,Course2,5,1,43535567,43539264,0,0,3697
5,1,Course3,0,1,43542626,43551449,0,0,8823
5,1,Course3,1,1,43554567,43561704,0,1,7137
5,1,Course3,2,1,43564641,43571633,0,2,6992
5,1,Course3,3,1,43574370,43581708,0,0,7338
5,1,Course3,4,1,43584344,43591482,0,1,7138
5,1,Course3,5,1,43594163,43601422,0,1,7259
6,0,Course1,0,1,65153031,65154718,0,0,1687
6,0,Course1,1,1,65163385,65165363,0,0,1978
6,0,Course1,2,1,65171841,65172701,0,0,860
6,0,Course1,3,1,65176643,65177303,0,0,660
6,0,Course1,4,1,65181201,65182429,0,0,1228
6,0,Course1,5,1,65186104,65187109,0,0,1005
6,0,Course2,0,1,65196593,65200167,0,1,3574
6,0,Course2,1,1,65206266,65209147,0,1,2881
6,0,Course2,2,1,65212856,65215726,0,1,2870
6,0,Course2,3,1,65221077,65223913,0,0,2836
6,0,Course2,4,1,65227856,65230615,0,0,2759
6,0,Course2,5,1,65234335,65237239,0,2,2904
6,0,Course3,0,1,65244924,65251704,0,3,6780
6,0,Course3,1,1,65256093,65262471,0,3,6378
6,0,Course3,2,1,65267038,65272143,0,1,5105
6,0,Course3,3,1,65276310,65282029,0,3,5719
6,0,Course3,4,1,65287021,65291668,0,2,4647
6,0,Course3,5,1,65296995,65302223,0,1,5228
6,0,Course1_VF,0,1,65841548,65842530,0,0,982
6,0,Course1_VF,1,1,65845937,65846931,0,0,994
6,0,Course1_VF,2,1,65850605,65851633,0,0,1028
6,0,Course1_VF,3,1,65854951,65855732,0,0,781
6,0,Course1_VF,4,1,65858826,65859575,0,0,749
6,0,Course1_VF,5,1,65863473,65864188,0,0,715
6,0,Course2_VF,0,1,65869851,65873559,0,2,3708
6,0,Course2_VF,1,1,65878273,65881803,0,0,3530
6,0,Course2_VF,2,1,65885879,65889085,0,2,3206
6,0,Course2_VF,3,1,65892481,65895284,0,3,2803
6,0,Course2_VF,4,1,65899584,65902723,0,2,3139
6,0,Course2_VF,5,1,65907035,65910005,0,2,2970
6,0,Course3_VF,0,1,65915579,65921097,0,2,5518
6,0,Course3_VF,1,1,65924863,65929453,0,1,4590
6,0,Course3_VF,2,1,65933160,65937807,0,1,4647
6,0,Course3_VF,3,1,65941214,65945380,0,1,4166
6,0,Course3_VF,4,1,65948719,65953031,2,3,4312
6,0,Course3_VF,5,1,65956963,65963519,0,1,6556
7,1,Course1_VF,0,0,30042532,30045023,0,0,2491
7,1,Course1_VF,1,0,30049459,30051189,0,0,1730
7,1,Course1_VF,2,0,30055678,30057287,0,0,1609
7,1,Course1_VF,3,0,30060549,30061979,0,0,1430
7,1,Course1_VF,4,0,30064827,30066257,0,0,1430
7,1,Course1_VF,5,0,30070289,30071741,0,0,1452
7,1,Course2_VF,0,0,30076432,30081179,0,0,4747
7,1,Course2_VF,1,0,30084675,30088597,0,0,3922
7,1,Course2_VF,2,0,30093533,30097129,0,1,3596
7,1,Course2_VF,3,0,30100648,30105138,0,0,4490
7,1,Course2_VF,4,0,30108222,30112320,0,1,4098
7,1,Course2_VF,5,0,30115448,30120151,0,1,4703
7,1,Course3_VF,0,0,30127834,30138301,0,3,10467
7,1,Course3_VF,1,0,30142511,30149113,0,5,6602
7,1,Course3_VF,2,0,30152620,30161075,0,2,8455
7,1,Course3_VF,3,0,30165118,30179461,0,6,14343
7,1,Course3_VF,4,0,30188475,30200683,0,6,12208
7,1,Course3_VF,5,0,30205362,30213762,0,4,8400
7,1,Course1,0,0,30660021,30661897,0,0,1876
7,1,Course1,1,0,30664020,30665796,0,0,1776
7,1,Course1,2,0,30667828,30669303,0,0,1475
7,1,Course1,3,0,30671492,30673280,0,0,1788
7,1,Course1,4,0,30675380,30677501,0,0,2121
7,1,Course1,5,0,30680474,30682483,0,0,2009
7,1,Course2,0,0,30686796,30692994,0,2,6198
7,1,Course2,1,0,30695418,30702534,0,1,7116
7,1,Course2,2,0,30705147,30710218,0,0,5071
7,1,Course2,3,0,30712150,30717065,0,0,4915
7,1,Course2,4,0,30719388,30723889,0,0,4501
7,1,Course2,5,0,30726592,30733115,0,1,6523
7,1,Course3,0,0,30737349,30743380,0,3,6031
7,1,Course3,1,0,30746799,30752361,0,7,5562
7,1,Course3,2,0,30755555,30762771,2,5,7216
7,1,Course3,3,0,30766300,30772097,0,1,5797
7,1,Course3,4,0,30775247,30780642,0,3,5395
7,1,Course3,5,0,30784205,30792214,0,4,8009
8,0,Course1,0,1,34922418,34924318,0,0,1900
8,0,Course1,1,1,34936146,34937744,0,0,1598
8,0,Course1,2,1,34941776,34943093,0,0,1317
8,0,Course1,3,1,34949069,34950141,0,0,1072
8,0,Course1,4,1,34955000,34956330,0,0,1330
8,0,Course1,5,1,34961267,34962406,0,0,1139
8,0,Course2,0,1,34975820,34979608,0,1,3788
8,0,Course2,1,1,34986868,34991391,0,1,4523
8,0,Course2,2,1,34995032,34999479,0,0,4447
8,0,Course2,3,1,35002538,35006225,0,1,3687
8,0,Course2,4,1,35010022,35016746,0,1,6724
8,0,Course2,5,1,35020387,35024409,0,1,4022
8,0,Course3,0,1,35038147,35045061,0,1,6914
8,0,Course3,1,1,35050266,35055337,0,6,5071
8,0,Course3,2,1,35060531,35068898,0,4,8367
8,0,Course3,3,1,35075822,35083630,0,2,7808
8,0,Course3,4,1,35086993,35092588,0,2,5595
8,0,Course3,5,1,35096599,35103356,0,4,6757
8,0,Course1_VF,0,1,35676289,35677663,0,0,1374
8,0,Course1_VF,1,1,35681304,35682365,0,0,1061
8,0,Course1_VF,2,1,35685369,35686196,0,0,827
8,0,Course1_VF,3,1,35689224,35690128,0,0,904
8,0,Course1_VF,4,1,35693076,35693992,0,0,916
8,0,Course1_VF,5,1,35702056,35702660,0,0,604
8,0,Course2_VF,0,1,35712322,35716343,0,2,4021
8,0,Course2_VF,1,1,35719364,35733421,0,1,14057
8,0,Course2_VF,2,1,35737319,35742379,0,1,5060
8,0,Course2_VF,3,1,35745462,35750813,0,2,5351
8,0,Course2_VF,4,1,35753839,35757603,0,0,3764
8,0,Course2_VF,5,1,35760419,35765368,0,1,4949
8,0,Course3_VF,0,1,35771152,35775899,2,6,4747
8,0,Course3_VF,1,1,35782512,35790856,0,2,8344
8,0,Course3_VF,2,1,35794441,35798741,0,7,4300
8,0,Course3_VF,3,1,35803489,35810950,0,1,7461
8,0,Course3_VF,4,1,35814882,35825157,0,0,10275
8,0,Course3_VF,5,1,35830373,35837958,0,1,7585
9,1,Course1_VF,0,1,40207976,40208870,0,0,894
9,1,Course1_VF,1,1,40213718,40214443,0,2,725
9,1,Course1_VF,2,1,40217907,40218968,0,1,1061
9,1,Course1_VF,3,1,40221815,40222642,0,1,827
9,1,Course1_VF,4,1,40225903,40226954,0,1,1051
9,1,Course1_VF,5,1,40230170,40233186,0,1,3016
9,1,Course2_VF,0,1,40237174,40240626,0,0,3452
9,1,Course2_VF,1,1,40243753,40246557,0,3,2804
9,1,Course2_VF,2,1,40249718,40252856,0,1,3138
9,1,Course2_VF,3,1,40255895,40258934,0,1,3039
9,1,Course2_VF,4,1,40262238,40265198,0,1,2960
9,1,Course2_VF,5,1,40268225,40277921,0,0,9696
9,1,Course3_VF,0,1,40281395,40286298,0,5,4903
9,1,Course3_VF,1,1,40290989,40293938,1,5,2949
9,1,Course3_VF,2,1,40297087,40302181,0,3,5094
9,1,Course3_VF,3,1,40305108,40310570,0,3,5462
9,1,Course3_VF,4,1,40313630,40317797,0,7,4167
9,1,Course3_VF,5,1,40320823,40328219,0,1,7396
9,1,Course1,0,1,40801518,40802758,0,0,1240
9,1,Course1,1,1,40805405,40806411,0,0,1006
9,1,Course1,2,1,40808856,40810543,0,0,1687
9,1,Course1,3,1,40813134,40813905,0,0,771
9,1,Course1,4,1,40816284,40817167,0,0,883
9,1,Course1,5,1,40819601,40820439,0,1,838
9,1,Course2,0,1,40823645,40826940,0,0,3295
9,1,Course2,1,1,40836311,40839137,0,1,2826
9,1,Course2,2,1,40842007,40845157,0,2,3150
9,1,Course2,3,1,40847749,40850798,0,1,3049
9,1,Course2,4,1,40853233,40857522,0,2,4289
9,1,Course2,5,1,40860225,40862816,0,3,2591
9,1,Course3,0,1,40866391,40873617,0,2,7226
9,1,Course3,1,1,40876556,40882465,0,2,5909
9,1,Course3,2,1,40885491,40893109,0,0,7618
9,1,Course3,3,1,40897733,40904413,0,4,6680
9,1,Course3,4,1,40908556,40914008,0,3,5452
9,1,Course3,5,1,40917258,40924093,0,2,6835
10,0,Course1,0,1,45688710,45692799,0,0,4089
10,0,Course1,1,1,45698484,45704068,0,1,5584
10,0,Course1,2,1,45712010,45717025,0,0,5015
10,0,Course1,3,1,45722621,45727725,0,0,5104
10,0,Course1,4,1,45732842,45737912,0,0,5070
10,0,Course1,5,1,45743843,45747854,0,0,4011
10,0,Course2,0,1,45753483,45762352,0,3,8869
10,0,Course2,1,1,45768071,45779107,0,2,11036
10,0,Course2,2,1,45783875,45795335,0,2,11460
10,0,Course2,3,1,45799782,45810348,0,1,10566
10,0,Course2,4,1,45814537,45823539,0,0,9002
10,0,Course2,5,1,45828487,45837490,0,0,9003
10,0,Course3,0,1,45843599,45860946,0,6,17347
10,0,Course3,1,1,45867323,45882514,0,2,15191
10,0,Course3,2,1,45887400,45903312,0,3,15912
10,0,Course3,3,1,45907858,45926064,1,9,18206
10,0,Course3,4,1,45929952,45942517,0,6,12565
10,0,Course3,5,1,45946706,45956725,0,3,10019
10,0,Course1_VF,0,1,46783712,46787542,0,0,3830
10,0,Course1_VF,1,1,46791854,46796489,0,0,4635
10,0,Course1_VF,2,1,46800253,46805269,0,0,5016
10,0,Course1_VF,3,1,46809234,46813780,0,0,4546
10,0,Course1_VF,4,1,46818705,46824548,0,0,5843
10,0,Course1_VF,5,1,46828937,46833461,0,0,4524
10,0,Course2_VF,0,1,46837460,46848641,0,1,11181
10,0,Course2_VF,1,1,46851824,46861865,0,0,10041
10,0,Course2_VF,2,1,46865015,46873918,0,0,8903
10,0,Course2_VF,3,1,46876654,46883311,0,0,6657
10,0,Course2_VF,4,1,46886327,46892437,0,1,6110
10,0,Course2_VF,5,1,46895664,46902008,0,0,6344
10,0,Course3_VF,0,1,46906387,46920718,0,3,14331
10,0,Course3_VF,1,1,46924716,46942789,1,6,18073
10,0,Course3_VF,2,1,46946530,46962269,0,2,15739
10,0,Course3_VF,3,1,46966391,46981525,0,0,15134
10,0,Course3_VF,4,1,46985100,46998313,0,1,13213
10,0,Course3_VF,5,1,47002055,47017413,0,9,15358
11,1,Course1_VF,0,1,51766705,51769575,0,0,2870
11,1,Course1_VF,1,1,51775117,51778198,0,0,3081
11,1,Course1_VF,2,1,51783069,51785403,0,0,2334
11,1,Course1_VF,3,1,51789994,51793143,0,0,3149
11,1,Course1_VF,4,1,51798103,51801554,0,0,3451
11,1,Course1_VF,5,1,51806748,51809339,0,0,2591
11,1,Course2_VF,0,1,51814009,51819772,0,3,5763
11,1,Course2_VF,1,1,51823738,51829914,0,0,6176
11,1,Course2_VF,2,1,51833934,51839597,0,0,5663
11,1,Course2_VF,3,1,51843094,51848980,0,1,5886
11,1,Course2_VF,4,1,51853315,51858262,0,0,4947
11,1,Course2_VF,5,1,51862786,51868572,0,0,5786
11,1,Course3_VF,0,1,51876045,51888153,0,5,12108
11,1,Course3_VF,1,1,51893290,51910212,0,7,16922
11,1,Course3_VF,2,1,51916009,51930440,0,2,14431
11,1,Course3_VF,3,1,51936293,51950100,0,4,13807
11,1,Course3_VF,4,1,51957304,51971690,0,5,14386
11,1,Course3_VF,5,1,51976515,51992800,0,1,16285
11,1,Course1,0,1,52485413,52487792,0,0,2379
11,1,Course1,1,1,52491969,52494360,0,0,2391
11,1,Course1,2,1,52498593,52501363,0,0,2770
11,1,Course1,3,1,52505876,52509295,0,0,3419
11,1,Course1,4,1,52513784,52516476,0,0,2692
11,1,Course1,5,1,52521043,52523145,0,0,2102
11,1,Course2,0,1,52528249,52533699,0,0,5450
11,1,Course2,1,1,52537542,52542489,0,0,4947
11,1,Course2,2,1,52545237,52549515,0,1,4278
11,1,Course2,3,1,52552945,52557469,0,4,4524
11,1,Course2,4,1,52560451,52565868,0,0,5417
11,1,Course2,5,1,52568794,52574200,0,1,5406
11,1,Course3,0,1,52577964,52597611,0,4,19647
11,1,Course3,1,1,52602794,52625134,0,6,22340
11,1,Course3,2,1,52632226,52650321,0,8,18095
11,1,Course3,3,1,52656833,52689995,0,4,33162
11,1,Course3,4,1,52697658,52720902,0,6,23244
11,1,Course3,5,1,52726152,52737903,0,1,11751
12,0,Course1,0,0,54227669,54231031,0,0,3362
12,0,Course1,1,0,54234584,54237209,0,0,2625
12,0,Course1,2,0,54240123,54241944,0,0,1821
12,0,Course1,3,0,54244792,54246625,0,0,1833
12,0,Course1,4,0,54249595,54251796,0,0,2201
12,0,Course1,5,0,54255024,54258263,0,1,3239
12,0,Course2,0,0,54262597,54272348,0,4,9751
12,0,Course2,1,0,54276347,54283321,0,4,6974
12,0,Course2,2,0,54293850,54299233,0,1,5383
12,0,Course2,3,0,54301993,54309342,0,2,7349
12,0,Course2,4,0,54311486,54317719,0,2,6233
12,0,Course2,5,0,54319953,54325191,0,0,5238
12,0,Course3,0,0,54328654,54338930,2,7,10276
12,0,Course3,1,0,54341287,54350523,0,4,9236
12,0,Course3,2,0,54367312,54379084,0,4,11772
12,0,Course3,3,0,54382916,54393884,2,4,10968
12,0,Course3,4,0,54397247,54402988,3,6,5741
12,0,Course3,5,0,54406563,54419150,0,5,12587
12,0,Course1_VF,0,0,54979652,54988565,0,4,8913
12,0,Course1_VF,1,0,54990966,54994016,0,0,3050
12,0,Course1_VF,2,0,54996674,54998942,0,0,2268
12,0,Course1_VF,3,0,55001265,55002694,0,0,1429
12,0,Course1_VF,4,0,55004627,55006772,0,0,2145
12,0,Course1_VF,5,0,55008982,55011106,0,0,2124
12,0,Course2_VF,0,0,55013463,55029412,1,9,15949
12,0,Course2_VF,1,0,55031781,55040482,0,1,8701
12,0,Course2_VF,2,0,55042425,55050757,0,2,8332
12,0,Course2_VF,3,0,55052421,55068160,0,5,15739
12,0,Course2_VF,4,0,55070092,55086813,0,3,16721
12,0,Course2_VF,5,0,55089941,55095246,0,0,5305
12,0,Course3_VF,0,0,55097972,55114704,0,13,16732
12,0,Course3_VF,1,0,55118167,55130319,0,7,12152
12,0,Course3_VF,2,0,55134083,55145287,0,9,11204
12,0,Course3_VF,3,0,55148637,55163269,0,12,14632
12,0,Course3_VF,4,0,55165861,55171423,0,7,5562
12,0,Course3_VF,5,0,55174293,55184357,1,8,10064
13,1,Course1_VF,0,1,58498768,58499963,0,0,1195
13,1,Course1_VF,1,1,58511424,58512630,0,0,1206
13,1,Course1_VF,2,1,58518673,58519823,0,0,1150
13,1,Course1_VF,3,1,58523397,58524403,0,0,1006
13,1,Course1_VF,4,1,58527799,58528837,0,0,1038
13,1,Course1_VF,5,1,58531640,58532691,0,0,1051
13,1,Course2_VF,0,1,58539392,58543949,0,0,4557
13,1,Course2_VF,1,1,58546642,58550149,0,1,3507
13,1,Course2_VF,2,1,58552617,58556950,0,2,4333
13,1,Course2_VF,3,1,58559576,58563150,0,1,3574
13,1,Course2_VF,4,1,58565998,58569338,0,0,3340
13,1,Course2_VF,5,1,58571840,58574867,0,2,3027
13,1,Course3_VF,0,1,58579279,58595173,0,6,15894
13,1,Course3_VF,1,1,58599160,58610285,1,5,11125
13,1,Course3_VF,2,1,58613358,58622863,1,4,9505
13,1,Course3_VF,3,1,58627342,58637205,1,9,9863
13,1,Course3_VF,4,1,58640767,58650240,3,7,9473
13,1,Course3_VF,5,1,58653634,58660147,0,3,6513
14,0,Course1,0,1,59457300,59458651,0,0,1351
14,0,Course1,1,1,59461007,59462638,0,0,1631
14,0,Course1,2,1,59464849,59466101,0,0,1252
14,0,Course1,3,1,59468178,59469240,0,0,1062
14,0,Course1,4,1,59471250,59472255,0,1,1005
14,0,Course1,5,1,59474511,59475796,0,0,1285
14,0,Course2,0,1,59478510,59483134,0,0,4624
14,0,Course2,1,1,59485323,59488887,0,0,3564
14,0,Course2,2,1,59490820,59494416,0,0,3596
14,0,Course2,3,1,59496415,59499688,0,1,3273
14,0,Course2,4,1,59501665,59505127,0,0,3462
14,0,Course2,5,1,59507059,59510165,0,0,3106
14,0,Course3,0,1,59513270,59521189,0,1,7919
14,0,Course3,1,1,59523490,59530996,0,2,7506
14,0,Course3,2,1,59533386,59539206,0,1,5820
14,0,Course3,3,1,59541484,59549403,0,2,7919
14,0,Course3,4,1,59551593,59558752,0,2,7159
14,0,Course3,5,1,59561187,59568771,0,2,7584
15,0,Course1,0,1,38389408,38393038,0,0,3630
15,0,Course1,1,1,38398323,38400532,0,0,2209
15,0,Course1,2,1,38403985,38405962,0,0,1977
15,0,Course1,3,1,38412262,38413725,0,0,1463
15,0,Course1,4,1,38418550,38419778,0,0,1228
15,0,Course1,5,1,38424470,38425397,0,0,927
15,0,Course2,0,1,38432020,38441280,0,0,9260
15,0,Course2,1,1,38447056,38456471,0,2,9415
15,0,Course2,2,1,38461330,38469215,0,3,7885
15,0,Course2,3,1,38473773,38488037,1,1,14264
15,0,Course2,4,1,38492392,38502780,0,1,10388
15,0,Course2,5,1,38506521,38517547,0,1,11026
15,0,Course3,0,1,38526694,38560650,0,8,33956
15,0,Course3,1,1,38569139,38606490,0,1,37351
15,0,Course3,2,1,38612064,38634927,0,5,22863
15,0,Course3,3,1,38639808,38672156,1,10,32348
15,0,Course3,5,1,38725881,38743452,0,0,17571
15,0,Course1_VF,0,1,39313436,39318339,0,0,4903
15,0,Course1_VF,1,1,39322461,39326102,0,0,3641
15,0,Course1_VF,2,1,39329320,39333530,0,0,4210
15,0,Course1_VF,3,1,39338724,39343392,0,0,4668
15,0,Course1_VF,4,1,39347559,39350620,0,0,3061
15,0,Course1_VF,5,1,39353646,39357633,0,0,3987
15,0,Course2_VF,0,1,39361912,39371820,0,0,9908
15,0,Course2_VF,1,1,39375260,39379928,0,0,4668
15,0,Course2_VF,2,1,39383169,39388385,0,1,5216
15,0,Course2_VF,3,1,39391478,39396673,0,0,5195
15,0,Course2_VF,4,1,39400011,39404591,0,0,4580
15,0,Course2_VF,5,1,39408937,39413437,0,0,4500
15,0,Course3_VF,0,1,39417738,39438122,1,5,20384
15,0,Course3_VF,1,1,39455681,39485940,0,4,30259
15,0,Course3_VF,2,1,39490586,39515171,0,0,24585
15,0,Course3_VF,3,1,39519370,39542123,0,3,22753
15,0,Course3_VF,5,1,39734943,39766889,0,4,31946
16,1,Course1_VF,0,0,43459670,43463379,0,1,3709
16,1,Course1_VF,1,0,43469566,43472761,0,0,3195
16,1,Course1_VF,2,0,43477742,43479678,0,0,1936
16,1,Course1_VF,3,0,43483194,43484613,0,0,1419
16,1,Course1_VF,4,0,43487918,43489046,0,1,1128
16,1,Course1_VF,5,0,43492510,43493307,0,1,797
16,1,Course2_VF,0,0,43498959,43505244,0,3,6285
16,1,Course2_VF,1,0,43508951,43517128,0,1,8177
16,1,Course2_VF,2,0,43521844,43527459,0,1,5615
16,1,Course2_VF,3,0,43531850,43537031,1,0,5181
16,1,Course2_VF,4,0,43540877,43543432,0,1,2555
16,1,Course2_VF,5,0,43547888,43551989,0,1,4101
16,1,Course3_VF,0,0,43558835,43573188,1,9,14353
16,1,Course3_VF,1,0,43581319,43597091,1,6,15772
16,1,Course3_VF,2,0,43602206,43607154,0,2,4948
16,1,Course3_VF,3,0,43611733,43616882,0,5,5149
16,1,Course3_VF,4,0,43622456,43627405,3,6,4949
16,1,Course3_VF,5,0,43633146,43638532,0,2,5386
16,1,Course1,0,0,44110970,44112489,0,0,1519
16,1,Course1,1,0,44119481,44121079,0,1,1598
16,1,Course1,2,0,44125770,44127438,0,0,1668
16,1,Course1,3,0,44131991,44133254,0,0,1263
16,1,Course1,4,0,44140010,44141419,0,0,1409
16,1,Course1,5,0,44144010,44145328,0,0,1318
16,1,Course2,0,0,44148031,44151371,0,1,3340
16,1,Course2,1,0,44154800,44157246,1,1,2446
16,1,Course2,2,0,44160386,44163121,0,1,2735
16,1,Course2,3,0,44165948,44169968,2,2,4020
16,1,Course2,4,0,44173788,44177909,0,1,4121
16,1,Course2,5,0,44183662,44190398,1,2,6736
16,1,Course3,0,0,44194496,44200507,0,5,6011
16,1,Course3,1,0,44203522,44206928,0,3,3406
16,1,Course3,2,0,44209531,44212669,3,5,3138
16,1,Course3,3,0,44219270,44222398,0,4,3128
16,1,Course3,4,0,44225124,44228151,0,3,3027
16,1,Course3,5,0,44230977,44234820,0,5,3843
17,0,Course1,0,1,47559082,47560020,0,0,938
17,0,Course1,1,1,47562087,47562757,0,0,670
17,0,Course1,2,1,47564633,47565159,0,0,526
17,0,Course1,3,1,47566957,47567470,0,1,513
17,0,Course1,4,1,47569201,47569704,0,0,503
17,0,Course1,5,1,47571480,47571961,0,0,481
17,0,Course2,0,1,47574564,47577747,0,1,3183
17,0,Course2,1,1,47580092,47584605,0,1,4513
17,0,Course2,2,1,47586760,47590760,0,1,4000
17,0,Course2,3,1,47593095,47596836,0,0,3741
17,0,Course2,4,1,47598813,47601237,0,1,2424
17,0,Course2,5,1,47603437,47606084,1,1,2647
17,0,Course3,0,1,47609334,47614361,0,4,5027
17,0,Course3,1,1,47616584,47620738,1,1,4154
17,0,Course3,2,1,47622978,47626435,0,1,3457
17,0,Course3,3,1,47628691,47632086,0,0,3395
17,0,Course3,4,1,47634220,47637571,0,1,3351
17,0,Course3,5,1,47639983,47643447,0,2,3464
17,0,Course1_VF,0,1,48307211,48309288,0,0,2077
17,0,Course1_VF,1,1,48311634,48313734,0,0,2100
17,0,Course1_VF,2,1,48316258,48318045,0,0,1787
17,0,Course1_VF,3,1,48320313,48322201,0,0,1888
17,0,Course1_VF,4,1,48324166,48325853,0,0,1687
17,0,Course1_VF,5,1,48328131,48330266,0,0,2135
17,0,Course2_VF,0,1,48333180,48339872,0,0,6692
17,0,Course2_VF,1,1,48341959,48346930,0,0,4971
17,0,Course2_VF,2,1,48348985,48353419,0,1,4434
17,0,Course2_VF,3,1,48355732,48360624,0,0,4892
17,0,Course2_VF,4,1,48362540,48367684,0,1,5144
17,0,Course2_VF,5,1,48370040,48375435,0,0,5395
17,0,Course3_VF,0,1,48378551,48386583,0,3,8032
17,0,Course3_VF,1,1,48388838,48398165,1,2,9327
17,0,Course3_VF,2,1,48400454,48408955,1,4,8501
17,0,Course3_VF,3,1,48411546,48419096,1,1,7550
17,0,Course3_VF,4,1,48421499,48428255,0,2,6756
17,0,Course3_VF,5,1,48430612,48436521,0,2,5909
18,1,Course1_VF,0,1,60067258,60069258,0,0,2000
18,1,Course1_VF,1,1,60074853,60077768,0,0,2915
18,1,Course1_VF,2,1,60083030,60085107,0,0,2077
18,1,Course1_VF,3,1,60088894,60090926,0,0,2032
18,1,Course1_VF,4,1,60095439,60096724,0,0,1285
18,1,Course1_VF,5,1,60100849,60101928,0,0,1079
18,1,Course2_VF,0,1,60110451,60117924,0,1,7473
18,1,Course2_VF,1,1,60122592,60126457,0,0,3865
18,1,Course2_VF,2,1,60131998,60135850,0,1,3852
18,1,Course2_VF,3,1,60142106,60146306,0,1,4200
18,1,Course2_VF,4,1,60152203,60156771,0,0,4568
18,1,Course2_VF,5,1,60160793,60166042,0,0,5249
18,1,Course3_VF,0,1,60169472,60175347,0,1,5875
18,1,Course3_VF,1,1,60180407,60186449,0,1,6042
18,1,Course3_VF,2,1,60191363,60198245,0,2,6882
18,1,Course3_VF,3,1,60202689,60206465,0,3,3776
18,1,Course3_VF,4,1,60210732,60215167,0,0,4435
18,1,Course3_VF,5,1,60218617,60223097,0,2,4480
18,1,Course1,0,1,61190809,61192516,0,0,1707
18,1,Course1,1,1,61196984,61197922,0,0,938
18,1,Course1,2,1,61201720,61202402,0,0,682
18,1,Course1,3,1,61205854,61207171,0,0,1317
18,1,Course1,4,1,61213628,61214655,0,0,1027
18,1,Course1,5,1,61217168,61218006,0,0,838
18,1,Course2,0,1,61220821,61224629,0,0,3808
18,1,Course2,1,1,61228494,61231241,0,2,2747
18,1,Course2,2,1,61235006,61237876,0,0,2870
18,1,Course2,3,1,61240289,61242310,0,0,2021
18,1,Course2,4,1,61244556,61246578,0,0,2022
18,1,Course2,5,1,61248834,61250665,0,1,1831
18,1,Course3,0,1,61253693,61257100,0,3,3407
18,1,Course3,1,1,61259311,61263299,0,0,3988
18,1,Course3,2,1,61265577,61269341,0,1,3764
18,1,Course3,3,1,61271720,61274849,0,2,3129
18,1,Course3,4,1,61276926,61279517,0,0,2591
18,1,Course3,5,1,61281471,61284364,1,2,2893
19,0,Course1,0,1,40410520,40415524,0,0,5004
19,0,Course1,1,1,40419713,40424795,0,0,5082
19,0,Course1,2,1,40428504,40433261,0,0,4757
19,0,Course1,3,1,40440533,40446375,0,1,5842
19,0,Course1,4,1,40451468,40454617,0,0,3149
19,0,Course1,5,1,40457511,40459342,0,0,1831
19,0,Course2,0,1,40464726,40469819,0,0,5093
19,0,Course2,1,1,40474857,40480118,0,0,5261
19,0,Course2,2,1,40482788,40487467,0,0,4679
19,0,Course2,3,1,40490037,40494002,0,0,3965
19,0,Course2,4,1,40496593,40500547,0,0,3954
19,0,Course2,5,1,40503083,40506646,0,0,3563
19,0,Course3,0,1,40513850,40521546,0,1,7696
19,0,Course3,1,1,40524841,40532984,0,0,8143
19,0,Course3,2,1,40535552,40543327,1,1,7775
19,0,Course3,3,1,40547437,40558953,0,4,11516
19,0,Course3,4,1,40567298,40577394,0,2,10096
19,0,Course3,5,1,40580454,40588542,0,0,8088
19,0,Course1_VF,0,1,41383716,41386342,0,0,2626
19,0,Course1_VF,1,1,41388519,41390832,0,0,2313
19,0,Course1_VF,2,1,41395612,41397578,0,0,1966
19,0,Course1_VF,3,1,41399901,41401610,0,0,1709
19,0,Course1_VF,4,1,41403800,41405520,0,0,1720
19,0,Course1_VF,5,1,41407697,41409998,0,0,2301
19,0,Course2_VF,0,1,41413015,41417405,0,0,4390
19,0,Course2_VF,1,1,41419493,41423303,0,0,3810
19,0,Course2_VF,2,1,41425915,41429389,0,0,3474
19,0,Course2_VF,3,1,41431333,41435097,0,1,3764
19,0,Course2_VF,4,1,41437186,41441285,0,0,4099
19,0,Course2_VF,5,1,41444381,41447317,0,0,2936
19,0,Course3_VF,0,1,41451874,41464373,2,8,12499
19,0,Course3_VF,1,1,41466976,41474929,0,0,7953
19,0,Course3_VF,2,1,41477720,41483518,0,0,5798
19,0,Course3_VF,3,1,41486700,41491760,0,0,5060
19,0,Course3_VF,4,1,41494821,41506292,0,1,11471
19,0,Course3_VF,5,1,41508649,41515228,0,0,6579
20,1,Course1_VF,0,1,65559957,65561117,0,0,1160
20,1,Course1_VF,1,1,65566044,65567071,0,0,1027
20,1,Course1_VF,2,1,65571997,65572901,0,0,904
20,1,Course1_VF,3,1,65576654,65577570,0,1,916
20,1,Course1_VF,4,1,65583076,65583858,0,1,782
20,1,Course1_VF,5,1,65588863,65589957,0,0,1094
20,1,Course2_VF,0,1,65594414,65598771,0,2,4357
20,1,Course2_VF,1,1,65602646,65607874,0,1,5228
20,1,Course2_VF,2,1,65613090,65617904,0,0,4814
20,1,Course2_VF,3,1,65622094,65626516,0,1,4422
20,1,Course2_VF,4,1,65630136,65634860,0,1,4724
20,1,Course2_VF,5,1,65638501,65642724,0,0,4223
20,1,Course3_VF,0,1,65647548,65657645,0,3,10097
20,1,Course3_VF,1,1,65662124,65677305,0,11,15181
20,1,Course3_VF,2,1,65681571,65700772,0,5,19201
20,1,Course3_VF,3,1,65705240,65732561,0,15,27321
20,1,Course3_VF,4,1,65738012,65758987,0,10,20975
20,1,Course3_VF,5,1,65763276,65779540,0,2,16264
20,1,Course1,0,1,66400190,66402635,0,0,2445
20,1,Course1,1,1,66406478,66408075,0,0,1597
20,1,Course1,2,1,66411594,66413079,0,0,1485
20,1,Course1,3,1,66416698,66418250,0,0,1552
20,1,Course1,4,1,66421669,66430917,0,0,9248
20,1,Course1,5,1,66434949,66436557,0,0,1608
20,1,Course2,0,1,66444019,66448386,0,1,4367
20,1,Course2,1,1,66452072,66456674,0,1,4602
20,1,Course2,2,1,66460014,66464728,0,1,4714
20,1,Course2,3,1,66468056,66472747,0,0,4691
20,1,Course2,4,1,66476120,66481482,0,3,5362
20,1,Course2,5,1,66484989,66489468,0,1,4479
20,1,Course3,0,1,66494171,66506658,0,4,12487
20,1,Course3,1,1,66510779,66521078,0,3,10299
20,1,Course3,2,1,66525289,66534180,0,3,8891
20,1,Course3,3,1,66538179,66547796,0,2,9617
20,1,Course3,4,1,66551973,66560518,0,2,8545
20,1,Course3,5,1,66564283,66573408,0,3,9125
21,0,Course1,0,1,67984931,67987187,0,0,2256
21,0,Course1,1,1,67992694,67994392,0,0,1698
21,0,Course1,2,1,67999172,68000441,0,0,1269
21,0,Course1,3,1,68004634,68005796,0,1,1162
21,0,Course1,4,1,68010923,68012554,0,0,1631
21,0,Course1,5,1,68017368,68019290,0,0,1922
21,0,Course2,0,1,68027600,68034100,0,1,6500
21,0,Course2,1,1,68038702,68044856,0,1,6154
21,0,Course2,2,1,68049749,68056271,0,1,6522
21,0,Course2,3,1,68060784,68066793,0,0,6009
21,0,Course2,4,1,68071196,68077338,0,0,6142
21,0,Course2,5,1,68081638,68086032,0,0,4394
21,0,Course3,0,1,68091791,68098091,0,0,6300
21,0,Course3,1,1,68102827,68109751,1,4,6924
21,0,Course3,2,1,68114889,68124228,5,4,9339
21,0,Course3,3,1,68129969,68141607,0,2,11638
21,0,Course3,4,1,68146590,68156899,0,1,10309
21,0,Course3,5,1,68161658,68168537,1,0,6879
21,0,Course1_VF,0,1,68704555,68707024,0,0,2469
21,0,Course1_VF,1,1,68711178,68713066,0,0,1888
21,0,Course1_VF,2,1,68717110,68719433,0,0,2323
21,0,Course1_VF,3,1,68723856,68727408,0,0,3552
21,0,Course1_VF,4,1,68731809,68733965,0,0,2156
21,0,Course1_VF,5,1,68738253,68740869,0,0,2616
21,0,Course2_VF,0,1,68746039,68751981,0,0,5942
21,0,Course2_VF,1,1,68755746,68760560,0,0,4814
21,0,Course2_VF,2,1,68764201,68768546,0,0,4345
21,0,Course2_VF,3,1,68772075,68776610,0,0,4535
21,0,Course2_VF,4,1,68780263,68784921,0,0,4658
21,0,Course2_VF,5,1,68788774,68794013,0,2,5239
21,0,Course3_VF,0,1,68799087,68808076,0,2,8989
21,0,Course3_VF,1,1,68812498,68821658,0,0,9160
21,0,Course3_VF,2,1,68825812,68833464,0,0,7652
21,0,Course3_VF,3,1,68837429,68844678,0,0,7249
21,0,Course3_VF,4,1,68848699,68856272,0,1,7573
21,0,Course3_VF,5,1,68860717,68869084,0,0,8367
22,1,Course1_VF,0,1,52546092,52546941,0,0,849
22,1,Course1_VF,1,1,52549431,52550101,0,0,670
22,1,Course1_VF,2,1,52575781,52576507,0,0,726
22,1,Course1_VF,3,1,52579359,52580114,0,0,755
22,1,Course1_VF,4,1,52585252,52586492,0,0,1240
22,1,Course1_VF,5,1,52590178,52591060,0,0,882
22,1,Course2_VF,0,1,52595249,52598601,0,3,3352
22,1,Course2_VF,1,1,52604553,52606989,0,2,2436
22,1,Course2_VF,3,1,52619889,52624112,0,1,4223
22,1,Course2_VF,4,1,52628424,52630746,0,2,2322
22,1,Course2_VF,5,1,52636945,52640073,0,0,3128
22,1,Course3_VF,0,1,52650193,52654593,0,4,4400
22,1,Course3_VF,1,1,52660223,52664735,0,5,4512
22,1,Course3_VF,2,1,52669929,52679022,0,5,9093
22,1,Course3_VF,3,1,52684025,52696278,0,3,12253
22,1,Course3_VF,4,1,52701136,52715311,0,4,14175
22,1,Course3_VF,5,1,52720337,52733473,0,2,13136
22,1,Course1,0,1,53549524,53550629,0,0,1105
22,1,Course1,1,1,53555734,53556917,0,0,1183
22,1,Course1,2,1,53567294,53568266,0,0,972
22,1,Course1,3,1,53582753,53585513,0,0,2760
22,1,Course1,4,1,53589734,53591834,0,0,2100
22,1,Course1,5,1,53594716,53595699,0,0,983
22,1,Course2,0,1,53600647,53605551,0,1,4904
22,1,Course2,1,1,53608510,53612487,0,2,3977
22,1,Course2,3,1,53635173,53638935,0,0,3762
22,1,Course2,4,1,53642857,53646621,0,0,3764
22,1,Course2,5,1,53649459,53653859,0,1,4400
22,1,Course3,0,1,53658728,53668111,0,3,9383
22,1,Course3,1,1,53675740,53686150,0,2,10410
22,1,Course3,2,1,53691623,53705284,0,1,13661
22,1,Course3,3,1,53710455,53720653,0,4,10198
22,1,Course3,4,1,53724070,53734995,0,1,10925
22,1,Course3,5,1,53738937,53748622,0,1,9685
23,0,Course1,0,1,55717095,55719218,0,0,2123
23,0,Course1,1,1,55724780,55727226,0,0,2446
23,0,Course1,2,1,55731728,55733716,0,0,1988
23,0,Course1,3,1,55738284,55740518,0,0,2234
23,0,Course1,4,1,55745712,55747946,0,0,2234
23,0,Course1,5,1,55753017,55754759,0,0,1742
23,0,Course2,0,1,55760043,55767694,0,0,7651
23,0,Course2,1,1,55771380,55778528,0,0,7148
23,0,Course2,2,1,55782215,55788626,0,0,6411
23,0,Course2,3,1,55792479,55798857,0,1,6378
23,0,Course2,4,1,55802309,55808173,0,1,5864
23,0,Course2,5,1,55811758,55817790,0,0,6032
23,0,Course3,0,1,55825831,55838263,0,5,12432
23,0,Course3,1,1,55844831,55855342,0,1,10511
23,0,Course3,2,1,55859005,55870934,2,4,11929
23,0,Course3,3,1,55874408,55885175,0,1,10767
23,0,Course3,4,1,55888750,55899752,0,0,11002
23,0,Course3,5,1,55904086,55913713,0,3,9627
23,0,Course1_VF,0,1,56592255,56595182,0,0,2927
23,0,Course1_VF,1,1,56598455,56600420,0,0,1965
23,0,Course1_VF,2,1,56603548,56605659,0,0,2111
23,0,Course1_VF,3,1,56608899,56610852,0,0,1953
23,0,Course1_VF,4,1,56614137,56616036,0,0,1899
23,0,Course1_VF,5,1,56619621,56621688,0,0,2067
23,0,Course2_VF,0,1,56626017,56632578,0,1,6561
23,0,Course2_VF,1,1,56635929,56643234,0,0,7305
23,0,Course2_VF,2,1,56646227,56651991,0,1,5764
23,0,Course2_VF,3,1,56655163,56661463,0,0,6300
23,0,Course2_VF,4,1,56667841,56673794,0,0,5953
23,0,Course2_VF,5,1,56677536,56683913,0,3,6377
23,0,Course3_VF,0,1,56688124,56696669,0,0,8545
23,0,Course3_VF,1,1,56700165,56708040,0,0,7875
23,0,Course3_VF,2,1,56711435,56719288,2,1,7853
23,0,Course3_VF,3,1,56722727,56731005,0,3,8278
23,0,Course3_VF,4,1,56734355,56742889,0,1,8534
23,0,Course3_VF,5,1,56745927,56754125,0,0,8198
24,1,Course1_VF,0,0,61897893,61899646,0,0,1753
24,1,Course1_VF,1,0,61904460,61905901,0,0,1441
24,1,Course1_VF,2,0,61909084,61910480,0,0,1396
24,1,Course1_VF,3,0,61913273,61914792,0,0,1519
24,1,Course1_VF,4,0,61917373,61918791,0,0,1418
24,1,Course1_VF,5,0,61921014,61922153,0,0,1139
24,1,Course2_VF,0,0,61925884,61930408,0,3,4524
24,1,Course2_VF,1,0,61933836,61939097,0,0,5261
24,1,Course2_VF,2,0,61942202,61946692,0,0,4490
24,1,Course2_VF,3,0,61949675,61953294,0,0,3619
24,1,Course2_VF,4,0,61956053,61961481,0,2,5428
24,1,Course2_VF,5,0,61964821,61970708,0,1,5887
24,1,Course3_VF,0,0,61975432,61983173,0,3,7741
24,1,Course3_VF,1,0,61987015,61996152,0,1,9137
24,1,Course3_VF,2,0,61998979,62006729,0,0,7750
24,1,Course3_VF,3,0,62009611,62020077,0,4,10466
24,1,Course3_VF,4,0,62023696,62035134,1,3,11438
24,1,Course3_VF,5,0,62039043,62051330,0,4,12287
24,1,Course1,0,0,62724599,62727190,0,1,2591
24,1,Course1,1,0,62729960,62732284,0,0,2324
24,1,Course1,2,0,62735076,62737232,0,0,2156
24,1,Course1,3,0,62739466,62741319,0,0,1853
24,1,Course1,4,0,62744046,62745810,0,0,1764
24,1,Course1,5,0,62748133,62749719,0,0,1586
24,1,Course2,0,0,62753170,62758812,0,1,5642
24,1,Course2,1,0,62761760,62768798,0,0,7038
24,1,Course2,2,0,62771702,62777610,0,0,5908
24,1,Course2,3,0,62780369,62785161,0,0,4792
24,1,Course2,4,0,62787551,62791941,0,0,4390
24,1,Course2,5,0,62794509,62799480,0,0,4971
24,1,Course3,0,0,62803222,62812715,0,4,9493
24,1,Course3,1,0,62815967,62825204,0,0,9237
24,1,Course3,2,0,62828365,62849732,0,7,21367
24,1,Course3,3,0,62855094,62866486,0,1,11392
24,1,Course3,4,0,62869827,62878249,0,0,8422
24,1,Course3,5,0,62881007,62889931,0,0,8924
26,0,Course1,0,0,51024049,51026942,0,1,2893
26,0,Course1,1,0,51030750,51032806,0,0,2056
26,0,Course1,2,0,51036235,51038212,0,0,1977
26,0,Course1,3,0,51041775,51044032,0,0,2257
26,0,Course1,4,0,51047227,51049773,0,0,2546
26,0,Course1,5,0,51053090,51055425,0,0,2335
26,0,Course2,0,0,51059849,51068996,0,1,9147
26,0,Course2,1,0,51073073,51082556,0,0,9483
26,0,Course2,2,0,51086096,51092876,0,0,6780
26,0,Course2,3,0,51096741,51103834,0,0,7093
26,0,Course2,4,0,51106916,51111641,0,0,4725
26,0,Course2,5,0,51115953,51121024,0,0,5071
26,0,Course3,0,0,51126932,51140057,0,1,13125
26,0,Course3,1,0,51145184,51154265,0,1,9081
26,0,Course3,2,0,51158420,51166943,0,4,8523
26,0,Course3,3,0,51172449,51186221,0,3,13772
26,0,Course3,4,0,51192542,51205779,0,9,13237
26,0,Course3,5,0,51213430,51226064,0,2,12634
26,0,Course1_VF,0,0,51890944,51894016,0,0,3072
26,0,Course1_VF,1,0,51897690,51900471,0,0,2781
26,0,Course1_VF,2,0,51903320,51905866,0,0,2546
26,0,Course1_VF,3,0,51908771,51911172,0,0,2401
26,0,Course1_VF,4,0,51914165,51916701,0,0,2536
26,0,Course1_VF,5,0,51919404,51921593,0,0,2189
26,0,Course2_VF,0,0,51926765,51934382,0,2,7617
26,0,Course2_VF,1,0,51937801,51945754,0,1,7953
26,0,Course2_VF,2,0,51948602,51956577,0,0,7975
26,0,Course2_VF,3,0,51959079,51965747,0,0,6668
26,0,Course2_VF,4,0,51968584,51974705,0,1,6121
26,0,Course2_VF,5,0,51977095,51983439,0,0,6344
26,0,Course3_VF,0,0,51986634,52001702,0,0,15068
26,0,Course3_VF,1,0,52005936,52016737,0,1,10801
26,0,Course3_VF,2,0,52020042,52032396,0,1,12354
26,0,Course3_VF,3,0,52036138,52048246,0,1,12108
26,0,Course3_VF,4,0,52051373,52065257,0,2,13884
26,0,Course3_VF,5,0,52069491,52082526,0,0,13035

28,1,Course1_VF,0,1,44346703,44349496,0,0,2793
28,1,Course1_VF,1,1,44352813,44375856,0,1,23043
28,1,Course1_VF,2,1,44380346,44383183,0,0,2837
28,1,Course1_VF,3,1,44386523,44387908,0,0,1385
28,1,Course1_VF,4,1,44393526,44396810,0,0,3284
28,1,Course1_VF,5,1,44399848,44402630,0,3,2782
28,1,Course2_VF,0,1,44406617,44412012,0,4,5395
28,1,Course2_VF,1,1,44415374,44419920,0,1,4546
28,1,Course2_VF,2,1,44423929,44429894,0,2,5965
28,1,Course2_VF,3,1,44433458,44441533,0,2,8075
28,1,Course2_VF,4,1,44445097,44450994,0,0,5897
28,1,Course2_VF,5,1,44453685,44458008,0,0,4323
28,1,Course3_VF,0,1,44463604,44471144,0,2,7540
28,1,Course3_VF,1,1,44473891,44481857,0,5,7966
28,1,Course3_VF,2,1,44486000,44492780,0,4,6780
28,1,Course3_VF,3,1,44495873,44504161,0,6,8288
28,1,Course3_VF,4,1,44509713,44514460,1,3,4747
28,1,Course3_VF,5,1,44518593,44527238,0,3,8645
28,1,Course1,0,1,45022822,45027747,0,0,4925
28,1,Course1,1,1,45031500,45034862,0,0,3362
28,1,Course1,2,1,45038225,45040637,0,0,2412
28,1,Course1,3,1,45044234,45046200,0,1,1966
28,1,Course1,4,1,45049673,45051550,0,0,1877
28,1,Course1,5,1,45054554,45056297,0,0,1743
28,1,Course2,0,1,45060486,45065434,0,0,4948
28,1,Course2,1,1,45067914,45071264,0,0,3350
28,1,Course2,2,1,45073499,45076883,0,1,3384
28,1,Course2,3,1,45079017,45081976,0,0,2959
28,1,Course2,4,1,45084088,45086936,0,0,2848
28,1,Course2,5,1,45089002,45091727,0,0,2725
28,1,Course3,0,1,45094139,45098428,1,3,4289
28,1,Course3,1,1,45100852,45104337,0,0,3485
28,1,Course3,2,1,45106695,45109945,0,2,3250
28,1,Course3,3,1,45112279,45115798,2,7,3519
28,1,Course3,4,1,45118288,45122198,0,1,3910
28,1,Course3,5,1,45124576,45129157,0,3,4581
29,0,Course1,0,1,49426369,49429049,0,0,2680
29,0,Course1,1,1,49434266,49436265,0,0,1999
29,0,Course1,2,1,49439705,49441794,0,0,2089
29,0,Course1,3,1,49445737,49447323,0,0,1586
29,0,Course1,4,1,49450350,49451422,0,0,1072
29,0,Course1,5,1,49453768,49454818,0,0,1050
29,0,Course2,0,1,49459130,49465440,0,0,6310
29,0,Course2,1,1,49468992,49473471,0,1,4479
29,0,Course2,2,1,49477291,49481479,0,0,4188
29,0,Course2,3,1,49484127,49488092,0,1,3965
29,0,Course2,4,1,49490706,49494995,0,0,4289
29,0,Course2,5,1,49497877,49502378,0,2,4501
29,0,Course3,0,1,49506354,49517535,0,4,11181
29,0,Course3,1,1,49520674,49528650,0,3,7976
29,0,Course3,2,1,49533038,49542845,0,4,9807
29,0,Course3,3,1,49545850,49556695,3,5,10845
29,0,Course3,4,1,49560069,49571831,0,4,11762
29,0,Course3,5,1,49577226,49587401,2,4,10175
29,0,Course1_VF,0,1,50183510,50186873,0,0,3363
29,0,Course1_VF,1,1,50190570,50195127,0,0,4557
29,0,Course1_VF,2,1,50197584,50199796,0,0,2212
29,0,Course1_VF,3,1,50202175,50203695,0,0,1520
29,0,Course1_VF,4,1,50205928,50207056,0,0,1128
29,0,Course1_VF,5,1,50209290,50210430,0,0,1140
29,0,Course2_VF,0,1,50212910,50220270,0,0,7360
29,0,Course2_VF,1,1,50222606,50227687,0,0,5081
29,0,Course2_VF,2,1,50229709,50234936,1,1,5227
29,0,Course2_VF,3,1,50237248,50243703,0,0,6455
29,0,Course2_VF,4,1,50246071,50252393,0,2,6322
29,0,Course2_VF,5,1,50254707,50261219,0,0,6512
29,0,Course3_VF,0,1,50264826,50275750,0,1,10924
29,0,Course3_VF,1,1,50279336,50287042,0,0,7706
29,0,Course3_VF,2,1,50289399,50298547,4,3,9148
29,0,Course3_VF,3,1,50301082,50308923,0,1,7841
29,0,Course3_VF,4,1,50311704,50318082,0,2,6378
29,0,Course3_VF,5,1,50320987,50329979,0,3,8992
30,1,Course1_VF,0,1,51295924,51297354,0,0,1430
30,1,Course1_VF,1,1,51300715,51302402,0,0,1687
30,1,Course1_VF,2,1,51305541,51306960,0,0,1419
30,1,Course1_VF,3,1,51310266,51311461,0,1,1195
30,1,Course1_VF,4,1,51314354,51315460,0,0,1106
30,1,Course1_VF,5,1,51318174,51319268,0,0,1094
30,1,Course2_VF,1,1,51331879,51337129,0,0,5250
30,1,Course2_VF,2,1,51340591,51345115,0,0,4524
30,1,Course2_VF,3,1,51348388,51352766,0,0,4378
30,1,Course2_VF,4,1,51355771,51359546,0,2,3775
30,1,Course2_VF,5,1,51362417,51366315,0,0,3898
30,1,Course3_VF,0,1,51371598,51380288,1,6,8690
30,1,Course3_VF,1,1,51383874,51392296,0,8,8422
30,1,Course3_VF,2,1,51395736,51400283,0,4,4547
30,1,Course3_VF,3,1,51403018,51408961,0,0,5943
30,1,Course3_VF,4,1,51412043,51418645,1,1,6602
30,1,Course3_VF,5,1,51421571,51428228,0,3,6657
30,1,Course1,0,1,51897083,51898011,0,0,928
30,1,Course1,1,1,51900356,51901250,0,0,894
30,1,Course1,2,1,51903641,51904600,0,0,959
30,1,Course1,3,1,51907003,51907873,0,0,870
30,1,Course1,4,1,51910342,51911336,0,0,994
30,1,Course1,5,1,51913760,51914609,0,0,849
30,1,Course2,1,1,51932279,51935830,0,0,3551
30,1,Course2,2,1,51938533,51942007,0,0,3474
30,1,Course2,3,1,51944498,51948229,0,0,3731
30,1,Course2,4,1,51950719,51954327,0,0,3608
30,1,Course2,5,1,51956628,51960202,0,1,3574
30,1,Course3,0,1,51963721,51970132,1,5,6411
30,1,Course3,1,1,51973170,51981335,0,2,8165
30,1,Course3,2,1,51984162,51992048,0,3,7886
30,1,Course3,3,1,51994995,52003105,0,1,8110
30,1,Course3,4,1,52006065,52014342,0,1,8277
30,1,Course3,5,1,52017402,52025792,0,3,8390
31,0,Course1,0,1,54520395,54522641,0,0,2246
31,0,Course1,1,1,54528818,54531130,0,0,2312
31,0,Course1,2,1,54535273,54537106,0,1,1833
31,0,Course1,3,1,54541473,54544064,0,0,2591
31,0,Course1,4,1,54548621,54551056,0,0,2435
31,0,Course1,5,1,54555480,54558272,0,0,2792
31,0,Course2,0,1,54563812,54575372,0,1,11560
31,0,Course2,1,1,54581393,54588429,0,0,7036
31,0,Course2,2,1,54593155,54599186,0,2,6031
31,0,Course2,3,1,54602503,54608850,0,2,6347
31,0,Course2,4,1,54612836,54618476,0,6,5640
31,0,Course2,5,1,54622408,54628674,0,1,6266
31,0,Course3,0,1,54634817,54646891,0,4,12074
31,0,Course3,1,1,54651359,54657570,0,2,6211
31,0,Course3,2,1,54664863,54671174,0,3,6311
31,0,Course3,3,1,54676848,54683841,0,3,6993
31,0,Course3,4,1,54689069,54695546,0,4,6477
31,0,Course3,5,1,54700171,54706906,0,2,6735
31,0,Course1_VF,0,1,55195900,55199430,0,0,3530
31,0,Course1_VF,1,1,55203663,55206377,0,0,2714
31,0,Course1_VF,2,1,55209940,55212602,0,0,2662
31,0,Course1_VF,3,1,55216173,55218954,0,0,2781
31,0,Course1_VF,4,1,55222786,55225276,0,0,2490
31,0,Course1_VF,5,1,55228906,55231386,0,0,2480
31,0,Course2_VF,0,1,55235597,55243841,0,0,8244
31,0,Course2_VF,1,1,55247225,55252576,0,0,5351
31,0,Course2_VF,2,1,55256261,55261647,0,0,5386
31,0,Course2_VF,3,1,55264851,55269977,0,0,5126
31,0,Course2_VF,4,1,55273217,55277919,0,0,4702
31,0,Course2_VF,5,1,55281058,55286005,0,0,4947
31,0,Course3_VF,0,1,55290071,55296237,0,3,6166
31,0,Course3_VF,1,1,55301487,55306379,0,4,4892
31,0,Course3_VF,2,1,55310434,55316097,1,3,5663
31,0,Course3_VF,3,1,55321012,55327256,1,5,6244
31,0,Course3_VF,4,1,55331288,55336382,1,5,5094
31,0,Course3_VF,5,1,55341843,55348488,0,3,6645
